R 1280 720

NO ./textures/mossy.xpm
SO ./textures/redbrick.xpm
WE ./textures/stone.xpm
EA ./textures/wood.xpm

S ./sprites/pnj.xpm

F 220,100,0
C 225,30,0

1 1 1 1 1 1 1 1 1 1 1
1 0 0 0 0 0 0 0 0 0 1
1 0 0 0 0 0 0 0 0 0 1
1 0 0 0 0 2 0 0 0 0 1
1 0 0 1 1 1 1 1 0 0 1
1 0 0 0 0 0 0 0 0 0 1
1 0 0 0 0 0 0 0 0 0 1
1 0 0 0 0 N 0 0 0 0 1
1 0 0 0 0 0 0 0 0 0 1
1 1 1 1 1 0 1 1 1 1 1
1 0 0 0 0 0 0 0 0 0 1
1 1 1 1 1 1 1 1 1 1 1