R 1920 1080

NO ./textures/north.xmp
SO ./textures/south.xmp
WE ./textures/west.xmp
EA ./textures/east.xmp

S ./textures/sprite.xmp

F 220,100,0
C 225,30,0

1 1 1 1 1 1 1 1 1 1 1
1 0 0 0 0 0 0 0 0 0 1
1 0 0 0 0 0 0 0 0 0 1
1 0 0 0 0 2 0 0 0 0 1
1 0 0 1 1 1 1 1 0 0 1
1 0 0 0 0 0 0 0 0 0 1
1 0 0 0 0 0 0 0 0 0 1
1 0 0 0 0 0 0 0 0 0 1
1 0 0 0 0 0 0 0 0 0 1
1 1 1 1 1 0 1 1 1 1 1
1 W 0 0 0 0 0 0 0 0 1
1 1 1 1 1 1 1 1 1 1 1
