R 1280 720

TX1 ./textures/fantasy/bricks.xpm
TX2 ./textures/fantasy/nether_bricks.xpm
TX3 ./textures/fantasy/polished_granite.xpm
TX4 ./textures/fantasy/red_nether_bricks.xpm

SP1 ./sprites/fantasy/crimson_roots.xpm
SP2 ./sprites/missing.xpm

CEL ./textures/fantasy/bricks.xpm
FLO ./textures/fantasy/acacia_planks.xpm

Map:
        1111111111111111111111111
        1000000000110000000000001
        101100000111000000#000001
        1001000000000000000000001
111111111011000001110000000000001
100000000011000001110111111111111
11110111111111011100000010001
11110111111111011101040010001
11000000110101011100000010001
1000#000000000001100000010001
10000000000000000001010010001
11000001110101011111011030N0111
11110111 1110101 101111000001
11111111 1111111 111111111211
