R 1280 720

TX1 ./textures/sci_fi/magenta_terracotta.xpm
TX2 ./textures/sci_fi/brown_terracotta.xpm
TX3 ./textures/sci_fi/pink_glazed_terracotta.xpm
TX4 ./textures/sci_fi/red_sandstone.xpm

SP1 ./sprites/sci_fi/bubble_coral.xpm
SP2 ./sprites/sci_fi/acacia_sapling.xpm

CEL ./textures/sci_fi/bricks.xpm
FLO ./textures/sci_fi/acacia_planks.xpm

Map:
22222222222222413222222222222
2000000@002200000#00#0#000002
20330000011100000000000010002
2003000#000000S00000@00010002
20440000022200000000000010002
20000000002200000222022220002
22220222222222022200000040002
22220222222222022202020040002
22000000220202022200000040002
20000000000000#02200000040002
20000000000000002204040040002
220000002202020000000@0000002
22220222220202000000000000002
2000000000@200000300000020002
20000000000000003030000202002
200@0000001000030003030002002
20000000001103000000000000002
20000000000000000000000000002
22222222222222222222222222222
