R 1280 720

NO ./textures/sci_fi/red_terracotta.xpm
SO ./textures/sci_fi/brown_terracotta.xpm
WE ./textures/sci_fi/purple_terracotta.xpm
EA ./textures/sci_fi/pink_terracotta.xpm

S ./sprites/sci_fi/bubble_coral.xpm

C 55,215,225
F 128,128,128

11111111111111111111111111111
10000000001100000200202000001
10110000011100000000000010001
10010002000000S00000000010001
10110000011100000000000010001
10000000001100000111011110001
11110111111111011100000010001
11110111111111011101010010001
11000000110101011100000010001
10000000000000201100000010001
10000000000000001101010010001
11000000110101000000000000001
11110111110101000000000000001
10000000001100000100000010001
10000000000000001010000101001
10000000001000010001010001001
10000000001101000000000000001
10000000000100000001010000001
11111111111111111111111111111
